111111111111111111111111111111
130000000000000000000000000031
101110111011111111110111011101
101410001010001000010100014101
101000141010104010010141000101
101110111010111111010111011101
100000000200000000003000000001
101111111011110011110111111101
101004001010000000010100400101
100011100000005000000001110001
101004001010000000010100400101
101111111011110011110111111101
100000000300000000003000000001
101110111010111111010111011101
101400001010104010010100004101
100011100010101011010001110001
101000041010001000010140000101
101110111011111111110111011101
130000000000000000000000000031
111111111111111111111111111111